XXXXEXXXXX
XX000000XX
XX0X0XX0XX
XX0X0XX0XX
XX0X0XX0XX
XX0X0XX0XX
XX0X0XX0XX
XX0X0XX0XX
XX0X0000XX
XXXXSXXXXX